####        ###### ###########
#                            #
#                            #
#  ####                ####  #
#  #                      #  #
#  #                      #  #
#  #                      #  #
#                            #
#                            #
#                            #
#                            #
#                            #
                             #
                             #
#                            #
#                             
#                             
#                            #
#                            #
#                            #
                              
#                            #
#                            #
#  #                      #  #
#  #                      #  #
#  #                      #  #
#  ####                ####  #
#                            #
#                            #
####      ##   ### ###########
