


   # ######################
   #
   #                      #
   #                      #
   #                      #
   #                      #
   #                      #
   #                      #
   #                      #
   #                      #
   #                      #
   #                      #
   #                      #
   #                      #
   #                      #
   #                      #
   #                      #
   #                      #
   #                      #
   #                      #
   #                      #
   #                      #
                          #
   ###################### #
